1111111111
10P000C001
100C000001
1001C1C101
101C1C1001
100000C001
100C000001
1111011101
100C0001E1
1111111111
