111111111
1CCCCCCP1
1C1111111
1C1111111
1C1111111
1C1111111
1CCCCCCE1
111111111
